1111111111111111111111111111111111111111
1000000000000000000000000000000000000001
1000000000000000000000000000000000000001
1000000000000000000000000000000000000001
1000000000000000000000000000000000000001
1000000000000000000000000000000000000001
1000000000000000000000000000000000000001
1000000000000000000000000000000000000001
1000000000000000000000000000000000000001
1000000000000000000000000000000000000001
1000030000000000000000000000000000000001
1000011111111100000112221110001110000001
1000010000000000000111111111111111000001
1000010000000000000000000000000000000001
1000010000000000000000000000000000000001
1000010001000000100000100001000110000011
1000010001000000000000000000000000000001
1000000000000000000000000000000000111001
1000000000000000000000000000011100000001
1000000000000000000000000000111122222221
1000000000000000000000000001111122222221
1111111111111111111111111111111111111111
1111111111111111111111111111111111111111