1111111111111111111111111111111111111111
1000000000000000000000000000000000000001
1000000000000000000000000000000000000001
1000000000000000000000000000000000000001
1000000000000000000000000000000000000001
1000000000000000000000000000000000000001
1000000000000000000000000000000000000001
1000000000000000000000000000010000000001
1000000000000000000000000000010000000001
1000000000000000000001000000010000000001
1000000000001000100000000200010000000001
1000011100001222222222222200010001000001
1000000000001111111111100000011001000001
1000000000000000100000000001110001000031
1100000000000000100000000000000001000011
1222211110000001100000111100000100010001
1111110000001000100000000000000000000001
1000000000001000100000000000000000000011
1000000011111100000000000000000000000001
1000000010000000000010000100001000010001
1221122212222211112222222222222222222221
1111111111111111111111111111111111111111
1111111111111111111111111111111111111111