1111111111111111111111111111111111111111
1000000000000000000000000000000000000001
1000000000000000000000000000000000000001
1000000000000000000000000000000000000001
1003000000000000000000000000000000000001
1001111100000100100100010001111111100001
1000000000000000000000000000000000100011
1000000000000000000000000000000000100001
1000000000000000000000000000000000110001
1000000000000000000000000000000000100001
1000000000000000000000000000000000100011
1000000000000011110000000000000000100001
1000000000000110000000000000000000110001
1000000000001100000000000000000000100001
1000000000011000000000000000000000100011
1000000000110000000000000000000000100001
1000000001100000000000000000000000110001
1000000011000000000000000000000000100001
1000000111111100000112222111000000000011
1000001100000000000012222211100000000001
1000011000000000000012222211110000000001
1111111111111111111111111111111111111111
1111111111111111111111111111111111111111